25 25f
1 0 1 1 1 0 0 1 0 1 0 1 0 1 1 1 1 1 0 1 0 0 0 1 1f f
1 1 1 0 0 1 1 0 1 1 0 0 1 1 0 0 0 0 0 0 1 1 1 0 1f f
1 0 0 1 0 1 1 1 1 1 0 1 0 1 1 1 0 0 1 1 0 1 1 0 1
1 1 0 1 1 0 0 1 0 0 1 0 1 0 1 1 1 0 1 0 0 1 1 1 1
0 1 0 0 1 1 0 0 0 1 1 0 1 1 0 1 0 1 1 0 1 1 1 1 1
1 0 1 0 0 0 0 1 0 1 1 1 0 1 1 0 0 1 1 0 0 1 0 0 1
0 1 0 1 1 1 1 1 0 0 1 1 0 0 0 1 1 1 0 1 1 0 0 1 1
1 1 1 0 1 0 0 1 0 0 1 0 0 0 1 1 0 1 0 1 1 0 0 0 1
0 0 1 1 0 1 1 0 0 1 1 1 1 1 0 1 0 0 0 1 1 1 1 1 1
1 1 0 0 1 1 0 0 1 1 1 1 0 0 1 0 0 1 1 1 1 0 1 0 1
1 1 1 1 0 0 0 0 0 1 0 1 0 0 0 0 1 0 1 1 1 1 1 1 1
0 0 1 0 1 1 0 0 1 1 1 0 1 0 0 1 1 1 1 0 0 1 1 1 1
1 1 1 1 1 0 1 0 0 1 1 1 1 0 1 1 1 1 0 1 0 1 1 1 1
0 0 0 1 1 1 1 0 1 1 0 0 1 1 0 0 1 1 1 0 0 1 1 1 1
1 1 0 0 1 1 1 1 0 0 1 1 0 1 1 0 0 0 1 1 1 1 0 1 1
0 0 1 1 1 1 0 0 1 0 1 1 1 1 0 0 0 0 1 0 0 0 1 0 1
1 1 1 0 1 1 0 1 1 1 0 1 1 1 1 1 0 1 0 1 1 1 0 0 1
1 1 0 1 0 0 1 0 0 1 1 0 0 1 0 0 1 0 1 0 1 1 1 1 1
0 0 0 0 1 0 0 0 1 1 0 1 1 0 0 1 1 1 1 1 1 1 0 1 1
1 1 1 0 0 0 0 1 0 1 1 0 1 1 0 1 1 0 0 1 0 0 0 0 1
1 1 1 1 1 1 1 1 0 0 0 1 0 1 1 1 1 1 1 1 1 1 1 1 1
0 0 0 1 1 1 1 1 1 0 0 1 1 1 0 1 1 1 1 1 0 1 1 1 1
0 1 1 0 0 0 0 1 0 1 0 1 1 0 0 0 0 0 1 0 0 1 0 0 1
1 1 0 0 1 1 1 0 0 1 0 1 1 1 1 0 0 0 1 0 0 1 0 0 1
0 0 0 0 0 0 0 0 0 0 0 0 0 0 0 0 0 0 0 0 0 0 0 0 1

0 0 0 0 0 0 0 1 0 1 1 1 0 1 0 0 0 0 1 0 1 0 1 1 0
0 1 0 1 1 1 0 1 0 0 0 1 1 0 1 0 1 1 0 1 0 0 0 0 1
0 1 0 1 0 0 0 0 0 0 0 0 0 1 0 0 0 1 0 0 0 0 0 1 1
0 0 1 1 1 0 0 1 0 0 0 0 1 1 1 0 0 1 0 1 0 1 0 0 0
1 0 1 1 1 1 1 1 1 1 0 1 1 0 0 0 1 1 0 1 0 0 0 0 0
0 0 1 1 0 1 0 0 0 1 0 0 0 1 0 0 1 1 0 1 0 0 1 1 1
0 1 0 0 0 0 1 1 1 1 0 0 1 0 1 1 0 0 1 1 0 1 1 0 0
0 0 0 0 0 0 1 1 1 1 1 0 0 0 1 0 1 0 0 0 0 1 0 0 0
0 0 0 1 1 0 0 0 1 1 0 0 0 1 1 0 0 1 0 0 0 0 0 1 1
0 1 0 0 0 0 1 0 0 0 0 1 0 1 1 0 0 1 1 1 0 0 0 1 0
0 0 1 0 1 1 1 1 1 0 0 1 1 1 0 0 0 1 0 0 1 1 1 0 0
1 1 0 1 1 0 1 0 1 1 0 1 1 1 1 1 0 0 0 1 0 1 0 0 0
0 0 0 0 0 1 0 0 1 0 0 0 0 1 0 0 0 0 1 0 0 0 0 0 0
1 1 0 1 0 0 0 0 0 1 0 1 1 0 0 0 1 0 0 1 1 0 0 0 0
0 0 1 0 0 0 0 0 0 1 1 0 1 1 1 0 0 0 1 0 0 0 1 1 0
0 0 0 1 1 0 0 1 0 0 0 0 0 0 0 0 0 1 1 0 0 0 1 1 0
0 0 0 1 0 0 1 1 0 1 0 0 0 0 1 0 1 0 1 1 1 1 1 0 0
1 1 1 0 0 0 1 1 1 1 1 1 1 0 0 0 0 0 0 0 1 0 0 1 1
1 0 0 0 1 0 1 0 0 0 1 1 0 0 1 1 0 0 1 0 0 0 0 0 0
0 0 0 0 1 0 0 0 1 1 0 1 1 0 1 0 0 0 1 0 1 0 0 1 1
0 0 1 1 0 0 0 0 1 1 1 0 1 0 0 0 0 0 0 1 0 0 0 0 0
1 0 0 1 0 0 0 0 0 0 0 1 0 0 0 0 0 0 0 0 1 1 0 0 0
0 1 0 0 0 0 0 1 0 1 1 1 0 0 0 1 1 0 1 0 1 1 1 0 1
0 0 1 0 0 0 0 1 1 1 1 0 0 0 0 0 1 1 1 0 0 0 0 1 1
1 1 1 1 1 1 1 1 1 1 1 1 1 1 1 1 1 1 1 1 1 1 1 1 1
